#Example: Most of Europe north of med.
mild_winter = {
	# Rohan + Isengard
	1 2 3 4 5 6 7 8 9 10 11 12 13 14 15 16 17 18 19 20 21 22 23 24 25 26 27 28 29 30 31 32 33 34 35 36 37 38 39 40 41 42 43 44 45 46 47 48 49 50 51 52 53 54 55 56 57 58 59 60 61 62 63 64 65 66 67 68 69 70 71 72 73 74 75 76 77 78 79 80 81 82 83 84 85 86 87 88 89 90 91 92 93 94 95 96 97 98 99 100 101 102 103 104 105 106 107 108 109 110 111 112 113
	# White Mountains
	
	# Gondor
	
	# Andrast
	
	# Ithilien
	
	# Harondor?
	
	# Umbar?
	
	# Enedwaith
	513 514 515 516 517 523 521 522 524 730 520 519 518 533 539 532 531 535 526 534 525 536 530 527 529 528 547 545 546 548 544 543 542 549 541 551 538 550 540 585 588 584 590 594 586 587 597 589 580 581 582 583 571 573 727 575 579 578 591 572 576 577 574 565 566 567 568 570 592 569 593 595 596 564 563 553 552 556 555 554 560 561 562 559 598 558 557
	
	# Dunland
	114 115 116 117 118 119 120 121 122 123 124 125 126 127 128 129 130 131 132 133 134 135 136 137 138 139 140 141 142 143 144 145 146 147 148 149 150 151 152 153 154 155 156 157 158 159 160 161 162 163 164 165 166 167 168 169 170 171 172
	
	# West Marches
	69 70 71 72 73 74 75 76 77 78 79 80 81 82 83 84 85 86 87
}

#Example: Inland Europe & Scandinavia
normal_winter = {
	# Rhovanion Anduin South
	173 174 175 176 177 178 179 180 181 182 183 184 185 186 187 188 189 190 191 192 193 194 195 196 197 198
	771 755 756 757 760 761 758 759 773 774 772 770 775 781 776 780 779 778 768 769 777 754
	602 599 600 601 606 751 752 753 603 608 607 749 750 609 610 611
}

#Example: Russia & Lappland
severe_winter = {
	# Blue Mountains
	
	# Misty Mountains
}

# Complete
#	e_calenardhon
#	e_rhovanion
#	k_dunland
#	k_druwaith
#	k_enedhwaith

# ToDo:
#	k_andrast
#	e_gondor
