#Example: Most of Europe north of med.

# = {\n	winter_severity_bias = 0.45\n}\n

mild_winter = {
	# Valinor 0.5
3900 3901 3902
	# Rohan + Isengard 0.45
1 3089 4 5 6 8 9 11 12 13 14 15 17 2 18 19 16 29 30 45 46 47 26 28 21 25 31 32 33 42 34 39 38 40 37 35 36 43 7 10 3 49 53 68 48 52 64 50 51 66 67 65 58 59 54 60 63 57 62 61 110 111 112 113 20 23
	# Enedhwaith + Westmarches 0.5
41 44 69 70 71 72 73 75 76 77 78 79 80 81 82 85 86 87 538 550 540 547 545 546 548 544 543 542 549 541 551 83 84 74 526 534 526 525 536 533 539 532 531 535 530 527 529 528 513 514 515 516 517 523 521 522 524 730 520 519 518 585 588 584 590 594 586 587 597 589 580 581 582 583 571 573 727 575 3899 579 578 591 572 576 577 574 565 566 567 568 570 592 569 593 595 596 564 563 553 552 556 555 554 560 561 562 559 598 558 557 151 152 154 155 156 157 27 153 24 22 167 168 169 170 171 172
	# Dunland 0.6
114 115 116 117 118 119 120 121 122 123 124 125 126 127 128 129 130 131 132 133 134 135 136 137 138 139 140 141 142 143 144 145 146 147 148 149 150 158 159 160 161 162 163 164 165 166
	#Gondor (mild winter, warm summer) 0.4
2804 218 2840 219 220 2835 2738 221 225 2746 222 2784 2845 2775 223 224 213 207 212 215 599 600 601 603
	# Gondor (mild winter) 0.3
199 201 200 202 203 205 2714 204 208 209 2830 210 2791 2815 216 2808 217 214 211 206 2795 2800 275 2729 279 278 261 2743 2750 263 262 2733 2745 2734 276 226 227 2730 235 2723 2735 234 237 2770 236 2767 238 239 1463 240 242 241 2754 243 2756 247 244 229 231 2718 233 232 2707 2710 2704 228 2713 230 604 2725 605 271 289 292 352 353 293 314 308 313 310 311 307 312 305 287 309 290 381 380 378 379 375 374 377 376 373 364 362 363 361 365 367 366 368 371 370 369 383 382 372 387 389 388 384 386 385 400 403 407 406 390 391 392 394 395 402 396 399 419 418 393 398 397 401 405 411 404 409 410 408 416 417 415 412 413 414 422 421 423 424 427 425 426 428 431 429 433 430 434 437 432 441 442 1537 439 440 435 438 436 452 537 453 1399 454 457 455 474 451 475 456 458 450 473 480 476 472 478 1595 477 479 481 443 482 466 470 469 468 464 463 465 461 462 460 459 447 446 1019 1020 445 448 449 444 471 467 483 485 484 487 489 488 486 499 500 501 502 503 504 505 506 507 511 510 512 509 508 495 494 493 496 498 497 491 490 492
	# Gondor (Belfalas, Harondor) 0.25
258 246 260 245 2839 256 259 257 254 2613 255 249 253 250 252 2612 248 264 265 267 266 268 272 277 2515 306 294 269 350 349 351 299 302 301 300 296 291 304 303 297 298 270 295 288 274 2523 273 2526 281 282 283 284 285 286 280 2535 315 318 319 316 317 320 324 322 327 321 328 331 332 333 323 326 325 334 330 329 338 337 335 336 341 339 340 348 347 342 346 343 344 345 420 935 936 1264 1265 937 938 2817 1014 942 943 2826 994 1011 1012 1270 944 946 945 1273 1272 993 954 948 951 949 950 947 953 955 956 952 958 957 988 989 1274 961 964 962 251 985 960 959 986 963 966 965 967 969
	# Gondor and Near Harad 0.2
2550 2558 1269 1267 2889 1010 1266 1268 994 1011 1012 1270 991 992 968 1000 983 1003 996 1002 1004 987 1006 984 1001 1005 997 998 1009 940 1277 1017 1276 1015 1008 1007 939 1275 1016 980 1284 1283 982 999 981 970 1279 1280 1282 972 1281 1278 880 1288 884 883 895 2883 894 1289 891 2882 892 890 893 896 898 1291 897 887 888 1290 971 973 976 974 990 889 977 978 975 979 995 902 911 910 900 901 899 2959 916 919 2947 918 920 786 787 836 838 784 783 1315 1314 1313 719 2958 782
	# Near Desert 0.05
886 881 882 885 1285 1286 1287 913 912 934 914 917 931 932 930 928 933 915 929 921 927 926 923 922 924 925 1316 1312 835 788 791 789 790 812 1321 793 792 811
	# Tolfalas, Umbar islands 0.1
357 356 355 354 359 358 360 1018 878 876
	# Umbar 0.25
819 820 870 2301 2302 843 869 846 847 848 845 844 821 818 822 1296 1299 849 2470 868 867 831 830 842 832 828 829 2105 840 827 2497 823 825 826 824 1307 1511 1524 2541 2547 834 833 841 853 854 852 850 851 855 859 860 862 861 857 856 858 2545 865 864 863 866 906 1309 879 875 874 873 1450 1454 1455 1456 1457 903 909 904 907 908 905
	# Near Harad 1.5
1403 1404 1405 1406 1407 1408 1409 1410 871 872 1298 1451 1452 1453 1458 1459 1460 1461 1462 1464 1465 1466
	# Rhovanion + Wold (mild) 0.55
88 89 90 91 92 93 94 95 97 98 99 100 96 55 56 101 102 103 104 105 106 107 108 109 602 606 607 3125 3126 3127 3128 3129 3130 3131 3132 3133 178 3134 177 173 175 174 180 176 179 3144 3150 3149 3140 769 768 777 778 775 776 779 781 780 3141 3146 3147 3143 3189 3142 3145 3148 3138 3135 772 773 774 770 3190 3136 3139 3137 3154 3155 3151 771 755 756 757 760 761 758 759
	# Rhun (mild) 0.5
	# Lothlorien 0.3
3108 3109 3110 3111 3112 3113 3114 3115 3116 3117 3118 3119 3120 3121 3122 3123 3124



	# Shire 0.4
	
	# Arnor 0.5
}

#Example: Inland Europe & Scandinavia
normal_winter = {
	# Rhovanion (normal) 0.6
3158 3164 3159 3167 3156 3152 3153 3157 3162 3166 3191 3165 3160 3163 3161 3174 3176 3187 3186 3173 3175 3177 3180 3183 3182 3181 3185
	# Rhun (normal) 0.6
	# Nurn 0.3
658 660 675 659 661 1432 1433 1434 1437 1436 1435 667 1030 1026 669 662 1444 639 663 718 664 691 1025 665 668 1447 1443 1028 1029 1238 666 689 1438 670 1446 1445 672 1239 1027 671 1431 1428 1429 674 677 676 673 678 1425 1426 1430 1424 1427 682 681 679 680 1423 1422 1421 1420 1418 785 723 720 724 1036 725 726 1035 1033 1032 1034 1031
	# Nurn 0.2
685 683 686 684 1419 1416 1417 1415 690 687 693 688 1411 1412 1413 1414 712 714 713 710 711 717 716 715 707 709 706 708 703 704 705
}

#Example: Russia & Lappland
severe_winter = {
	# Mountains of Mordor 0.7
654 655 653 650 652 657 2585 656 1448
	# Rhovanion (severe) 0.7
3171 3169 3168 3170 3179 3178 3209 3208 3207 3202 3201 3172 3200 3203 3193 3197 3198 3199 3196 3192 3194 3195 3204 3205 3206
	# Rhun (severe) 0.7
	# Blue Mountains 0.8

	# Misty Mountains 0.8
3210 3213 3211 3212 3215 3214
	# Forodwaith (polar) 1

}

# Complete
#	e_temp_valinor
#	e_gondor_steward
#	e_enedhwaith
#	e_calenardhon
#	e_mordor
#	e_haradwaith
#	e_umbar
#	e_laurelindorenan

#	k_anduin_vale
#	k_langwell
#	k_gundabad


# ToDo:
#	e_bellakar
#	e_bozisha_miraz
#	e_nafarat
#	e_dune_sea
#	e_thani_hazad

#	k_lasgalen
#	k_angaladh
#	k_amon_lanc

#	e_rhovanion
#	e_rhun







